╔═══════                       
║                        
║.╔═════════╦═══════╦═══════╦═╗
║.║ ╦╦╦╦ ╔══╩╦════╗ ╚═╗     ║ ║
║.║ ╩╩╩╩  ........║   ║     ║ ║
║.║ ╬╬╬╬ ║.╔════╗.╠═══╝ ╚═══╝ ║
║.╚══════╝.║    ║.║           ║
║..........║    ╣.║           ║
║ ╔════╦═══╝    ║.╠           ║
║ ║        ╔════╣.║           ║
║ ╠  ╦═════╝    ║.╚═══════╗   ║
║ ║             ║.........║   ║  
║ ║             ╚══╦════╗.║   ║
║ ║  ╔════════╗    ║     .╠   ║
║ ║  ║        ║    ║    ║.║   ║
║ ║  ║ ╔═  ═╗ ╚══       ║.║   ║
║ ╠══╣             ║    ║.╠   ║
║ ║  ║ ╚═  ═╩══════╩════╝.║   ║
╠═╝ ......................║   ║   
║   .╚════════════════════╝   ╣
║   ......                    ║
╚══╩═══╝ F ╚═══════╩══════════╝